width: 100
height: 20
-0001-0001-0001-0001-0001-0001-0001-0001-0001-0001-0001-0001-0001-0001-0001-0001-0001-0001-0001-0001-0001-0001-0001-0001-0001-0001-0001-0001-0001-0001-0001-0001-0001-0001-0001-0001-0001-0001-0001-0001-0001-0001-0001-0001-0001-0001-0001-0001-0001-0001-0001-0001-0001-0001-0001-0001-0001-0001-0001-0001-0001-0001-0001-0001-0001-0001-0001-0001-0001-0001-0001-0001-0001-0001-0001-0001-0001-0001-0001-0001-0001-0001-0001-0001-0001-0001-0001-0001-0001-0001-0001-0001-0001-0001-0001-0001-0001-0001-0001-0001
-0001-0001-0001-0001-0001-0001-0001-0001-0001-0001-0001-0001-0001-0001-0001-0001-0001-0001-0001-0001-0001-0001-0001-0001-0001-0001-0001-0001-0001-0001-0001-0001-0001-0001-0001-0001-0001-0001-0001-0001-0001-0001-0001-0001-0001-0001-0001-0001-0001-0001-0001-0001-0001-0001-0001-0001-0001-0001-0001-0001-0001-0001-0001-0001-0001-0001-0001-0001-0001-0001-0001-0001-0001-0001-0001-0001-0001-0001-0001-0001-0001-0001-0001-0001-0001-0001-0001-0001-0001-0001-0001-0001-0001-0001-0001-0001-0001-0001-0001-0001
-0001-0001-0001-0001-0001-0001-0001-0001-0001-0001-0001-0001-0001-0001-0001-0001-0001-0001-0001-0001-0001-0001-0001-0001-0001-0001-0001-0001-0001-0001-0001-0001-0001-0001-0001-0001-0001-0001-0001-0001-0001-0001-0001-0001-0001-0001-0001-0001-0001-0001-0001-0001-0001-0001-0001-0001-0001-0001-0001-0001-0001-0001-0001-0001-0001-0001-0001-0001-0001-0001-0001-0001-0001-0001-0001-0001-0001-0001-0001-0001-0001-0001-0001-0001-0001-0001-0001-0001-0001-0001-0001-0001-0001-0001-0001-0001-0001-0001-0001-0001
-0001-0001-0001-0001-0001-0001-0001-0001-0001-0001-0001-0001-0001-0001-0001-0001-0001-0001-0001-0001-0001-0001-0001-0001-0001-0001-0001-0001-0001-0001-0001-0001-0001-0001-0001-0001-0001-0001-0001-0001-0001-0001-0001-0001-0001-0001-0001-0001-0001-0001-0001-0001-0001-0001-0001-0001-0001-0001-0001-0001-0001-0001-0001-0001-0001-0001-0001-0001-0001-0001-0001-0001-0001-0001-0001-0001-0001-0001-0001-0001-0001-0001-0001-0001-0001-0001-0001-0001-0001-0001-0001-0001-0001-0001-0001-0001-0001-0001-0001-0001
-0001-0001-0001-0001-0001-0001-0001-0001-0001-0001-0001-0001-0001-0001-0001-0001-0001-0001-0001-0001-0001-0001-0001-0001-0001-0001-0001-0001-0001-0001-0001-0001-0001-0001-0001-0001-0001-0001-0001-0001-0001-0001-0001-0001-0001-0001-0001-0001-0001-0001-0001-0001-0001-0001-0001-0001-0001-0001-0001-0001-0001-0001-0001-0001-0001-0001-0001-0001-0001-0001-0001-0001-0001-0001-0001-0001-0001-0001-0001-0001-0001-0001-0001-0001-0001-0001-0001-0001-0001-0001-0001-0001-0001-0001-0001-0001-0001-0001-0001-0001
-0001-0001-0001-0001-0001-0001-0001-0001-0001-0001-0001-0001-0001-0001-0001-0001-0001-0001-0001-0001-0001-0001-0001-0001-0001-0001-0001-0001-0001-0001-0001-0001-0001-0001-0001-0001-0001-0001-0001-0001-0001-0001-0001-0001-0001-0001-0001-0001-0001-0001-0001-0001-0001-0001-0001-0001-0001-0001-0001-0001-0001-0001-0001-0001-0001-0001-0001-0001-0001-0001-0001-0001-0001-0001-0001-0001-0001-0001-0001-0001-0001-0001-0001-0001-0001-0001-0001-0001-0001-0001-0001-0001-0001-0001-0001-0001-0001-0001-0001-0001
-0001-0001-0001-0001-0001-0001-0001-0001-0001-0001-0001-0001-0001-0001-0001-0001-0001-0001-0001-0001-0001-0001-0001-0001-0001-0001-0001-0001-0001-0001-0001-0001-0001-0001-0001-0001-0001-0001-0001-0001-0001-0001-0001-0001-0001-0001-0001-0001-0001-0001-0001-0001-0001-0001-0001-0001-0001-0001-0001-0001-0001-0001-0001-0001-0001-0001-0001-0001-0001-0001-0001-0001-0001-0001-0001-0001-0001-0001-0001-0001-0001-0001-0001-0001-0001-0001-0001-0001-0001-0001-0001-0001-0001-0001-0001-0001-0001-0001-0001-0001
-0001-0001-0001-0001-0001-0001-0001-0001-0001-0001-0001-0001-0001-0001-0001-0001-0001-0001-0001-0001-0001-0001-0001-0001-0001-0001-0001-0001-0001-0001-0001-0001-0001-0001-0001-0001-0001-0001-0001-0001-0001-0001-0001-0001-0001-0001-0001-0001-0001-0001-0001-0001-0001-0001-0001-0001-0001-0001-0001-0001-0001-0001-0001-0001-0001-0001-0001-0001-0001-0001-0001-0001-0001-0001-0001-0001-0001-0001-0001-0001-0001-0001-0001-0001-0001-0001-0001-0001-0001-0001-0001-0001-0001-0001-0001-0001-0001-0001-0001-0001
-0001-0001-0001-0001-0001-0001-0001-0001-0001-0001-0001-0001-0001-0001-0001-0001-0001-0001-0001-0001-0001-0001-0001-0001-0001-0001-0001-0001-0001-0001-0001-0001-0001-0001-0001-0001-0001-0001-0001-0001-0001-0001-0001-0001-0001-0001-0001-0001-0001-0001-0001-0001-0001-0001-0001-0001-0001-0001-0001-0001-0001-0001-0001-0001-0001-0001-0001-0001-0001-0001-0001-0001-0001-0001-0001-0001-0001-0001-0001-0001-0001-0001-0001-0001-0001-0001-0001-0001-0001-0001-0001-0001-0001-0001-0001-0001-0001-0001-0001-0001
-0001-0001-0001-0001-0001-0001-0001-0001-0001-0001-0001-0001-0001-0001-0001-0001-0001-0001-0001-0001-0001-0001-0001-0001-0001-0001-0001-0001-0001-0001-0001-0001-0001-0001-0001-0001-0001-0001-0001-0001-0001-0001-0001-0001-0001-0001-0001-0001-0001-0001-0001-0001-0001-0001-0001-0001-0001-0001-0001-0001-0001-0001-0001-0001-0001-0001-0001-0001-0001-0001-0001-0001-0001-0001-0001-0001-0001-0001-0001-0001-0001-0001-0001-0001-0001-0001-0001-0001-0001-0001-0001-0001-0001-0001-0001-0001-0001-0001-0001-0001
-0001-0001-0001-0001-0001-0001-0001-0001-0001-0001-0001-0001-0001-0001-0001-0001-0001-0001-0001-0001-0001-0001-0001-0001-0001-0001-0001-0001-0001-0001-0001-0001-0001-0001-0001-0001-0001-0001-0001-0001-0001-0001-0001-0001-0001-0001-0001-0001-0001-0001-0001-0001-0001-0001-0001-0001-0001-0001-0001-0001-0001-0001-0001-0001-0001-0001-0001-0001-0001-0001-0001-0001-0001-0001-0001-0001-0001-0001-0001-0001-0001-0001-0001-0001-0001-0001-0001-0001-0001-0001-0001-0001-0001-0001-0001-0001-0001-0001-0001-0001
-0001-0001-0001-0001-0001-0001-0001-0001-0001-0001-0001-0001-0001-0001-0001-0001-0001-0001-0001-0001-0001-0001-0001-0001-0001-0001-0001-0001-0001-0001-0001-0001-0001-0001-0001-0001-0001-0001-0001-0001-0001-0001-0001-0001-0001-0001-0001-0001-0001-0001-0001-0001-0001-0001-0001-0001-0001-0001-0001-0001-0001-0001-0001-0001-0001-0001-0001-0001-0001-0001-0001-0001-0001-0001-0001-0001-0001-0001-0001-0001-0001-0001-0001-0001-0001-0001-0001-0001-0001-0001-0001-0001-0001-0001-0001-0001-0001-0001-0001-0001
-0001-0001-0001-0001-0001-0001-0001-0001-0001-0001-0001-0001-0001-0001-0001-0001-0001-0001-0001-0001-0001-0001-0001-0001-0001-0001-0001-0001-0001-0001-0001-0001-0001-0001-0001-0001-0001-0001-0001-0001-0001-0001-0001-0001-0001-0001-0001-0001-0001-0001-0001-0001-0001-0001-0001-0001-0001-0001-0001-0001-0001-0001-0001-0001-0001-0001-0001-0001-0001-0001-0001-0001-0001-0001-0001-0001-0001-0001-0001-0001-0001-0001-0001-0001-0001-0001-0001-0001-0001-0001-0001-0001-0001-0001-0001-0001-0001-0001-0001-0001
-0001-0001-0001-0001-0001-0001-0001-0001-0001-0001-0001-0001-0001-0001-0001-0001-0001-0001-0001-0001-0001-0001-0001-0001-0001-0001-0001-0001-0001-0001-0001-0001-0001-0001-0001-0001-0001-0001-0001-0001-0001-0001-0001-0001-0001-0001-0001-0001-0001-0001-0001-0001-0001-0001-0001-0001-0001-0001-0001-0001-0001-0001-0001-0001-0001-0001-0001-0001-0001-0001-0001-0001-0001-0001-0001-0001-0001-0001-0001-0001-0001-0001-0001-0001-0001-0001-0001-0001-0001-0001-0001-0001-0001-0001-0001-0001-0001-0001-0001-0001
-0001-0001-0001-0001-0001-0001-0001-0001-0001-0001-0001-0001-0001-0001-0001-0001-0001-0001-0001-0001-0001-0001-0001-0001-0001-0001-0001-0001-0001-0001-0001-0001-0001-0001-0001-0001-0001-0001-0001-0001-0001-0001-0001-0001-0001-0001-0001-0001-0001-0001-0001-0001-0001-0001-0001-0001-0001-0001-0001-0001-0001-0001-0001-0001-0001-0001-0001-0001-0001-0001-0001-0001-0001-0001-0001-0001-0001-0001-0001-0001-0001-0001-0001-0001-0001-0001-0001-0001-0001-0001-0001-0001-0001-0001-0001-0001-0001-0001-0001-0001
-0001-0001-0001-0001000000000000000-0001-0001-0001-0001-0001-0001-0001-0001-0001-0001-0001-0001-0001-0001-0001-0001-0001-0001-0001-0001-0001-0001-0001-0001-0001-0001-0001-0001-0001-0001-0001-0001-0001-0001-0001-0001-0001-0001-0001-0001-0001-0001-0001-0001-0001-0001-0001-0001-0001-0001-0001-0001-0001-0001-0001-0001-0001-0001-0001-0001-0001-0001-0001-0001-0001-0001-0001-0001-0001-0001-0001-0001-0001-0001-0001-0001-0001-0001-0001-0001-0001-0001-0001-0001-0001-0001-0001-0001-0001-0001-0001-0001-0001
-0001-0001-000100000000000000000000-0001-0001-0001-0001-0001-0001-0001-0001-0001-0001-0001-0001-0001-0001-0001-0001-0001-0001-0001-0001-0001-0001-0001-0001-0001-0001-0001-0001-0001-0001-0001-0001-0001-0001-0001-0001-0001-0001-0001-0001-0001-0001-0001-0001-0001-0001-0001-0001-0001-0001-0001-0001-0001-0001-0001-0001-0001-0001-0001-0001-0001-0001-0001-0001-0001-0001-0001-0001-0001-0001-0001-0001-0001-0001-0001-0001-0001-0001-0001-0001-0001-0001-0001-0001-0001-0001-0001-0001-0001-0001-0001-0001-0001
-0001-00010000000000000000010100101-0001-0001-0001-0001-0001-0001-0001-0001-0001-0001-0001-0001-0001-0001-0001-0001-0001-0001-0001-0001-0001-0001-0001-0001-0001-0001-0001-0001-0001-0001-0001-0001-0001-0001-0001-0001-0001-0001-0001-0001-0001-0001-0001-0001-0001-0001-0001-0001-0001-0001-0001-0001-0001-0001-0001-0001-0001-0001-0001-0001-0001-0001-0001-0001-0001-0001-0001-0001-0001-0001-0001-0001-0001-0001-0001-0001-0001-0001-0001-0001-0001-0001-0001-0001-0001-0001-0001-0001-0001-0001-0001-0001-0001
-000100000000000000000101-0001-0001-0001-0001-0001-0001-0001-0001-0001-0001-0001-0001-0001-0001-0001-0001-0001-0001-0001-0001-0001-0001-0001-0001-0001-0001-0001-0001-0001-0001-0001-0001-0001-0001-0001-0001-0001-0001-0001-0001-0001-0001-0001-0001-0001-0001-0001-0001-0001-0001-0001-0001-0001-0001-0001-0001-0001-0001-0001-0001-0001-0001-0001-0001-0001-0001-0001-0001-0001-0001-0001-0001-0001-0001-0001-0001-0001-0001-0001-0001-0001-0001-0001-0001-0001-0001-0001-0001-0001-0001-0001-0001-0001-0001-0001
00000000000000000101-0001-0001-0001-0001-0001-0001-0001-0001-0001-0001-0001-0001-0001-0001-0001-0001-0001-0001-0001-0001-0001-0001-0001-0001-0001-0001-0001-0001-0001-0001-0001-0001-0001-0001-0001-0001-0001-0001-0001-0001-0001-0001-0001-0001-0001-0001-0001-0001-0001-0001-0001-0001-0001-0001-0001-0001-0001-0001-0001-0001-0001-0001-0001-0001-0001-0001-0001-0001-0001-0001-0001-0001-0001-0001-0001-0001-0001-0001-0001-0001-0001-0001-0001-0001-0001-0001-0001-0001-0001-0001-0001-0001-0001-0001-0001-0001
